17 x 11
***********
*         *
*         *
*         *
*  *      *
*    * R  *
*      R  *
*     *   *
*   RR   **
*H        *
*         *
** *    * *
*         *
*         *
*         *
*  *      *
***********
