13 x 22
**********************
*       *  *         *
*       *            *
*   H        R      **
*          R         *
*  *        R   *    *
*     *       *      *
*             *     R*
*                    *
*                    *
*                    *
*                    *
**********************
