19 x 38
**************************************
*  + R  +               *            *
*   R                 *       +    H *
*                         +          *
*+  +                            +   *
O                                    *
**  +         +    *      R          *
*          + +                       *
*                +                   *
O        R      +                    O
*  +           R    +                *
*             *       +  *     +     *
*                           +        *
*   +                                *
*                                    *
*                                    *
*                               +++  *
*       *                            *
**************************************
