28 x 56
****O****************O***************O******************
*  +                  +                           + +  *
*                R                                     *
*              +                     R        R        *
*                   *                                  *
*                               R           R          *
*+            +                 *                      *
*       +                   +                          *
*                  R                           *       *
*                                                    + *
*                                                      *
*                                                      *
* *      R                                R            *
*                              +                       *
*    +             +              R                    *
*            R              +                          *
*                                   *                * *
*                        +                           H *
*                                                      *
* +                                                    *
*R                                                     *
*                                                      *
*                                 +                    *
*                                                      *
*                                                      *
*                                                      *
*                                 +         *          *
********************************************************
