16 x 32
***O****************************
O+   ++    +   +     + * +   + *
*     + +*  R               ++ O
*                     +  R     *
*           +                  *
*                   +          *
*      H            R     +    *
*                              *
*   *            R            **
*                        +     *
*        * +             R     *
*                              *
*                              *
*+            R                *
*                 +  R         *
********************************
